12,12
############
#@########$#
#  GL&&G&& #
# ##########
# # %  !#? #
#   ## ##HB#
#G# #~~~####
# # #~~~#F!#
#N  #~~~#! #
###### ### #
#   P   F  #
############
3,10,START
3,5,wall,UP,ENEMY
2,TOKEN
